{
  "countries": [
    {
      "countryId": 1,
      "code": "BG",
      "name": "Bulgaria",
      "color": "#22C55E",
      "regionIds": [
        101, 102, 103,   104, 105, 106,   107, 108, 109,
        110, 111, 112,   113, 114, 115,   116, 117, 118,
        119, 120, 121,   122, 123, 124,   125, 126, 127,
        128
      ]
    },
    {
      "countryId": 2,
      "code": "RO",
      "name": "Romania",
      "color": "#3B82F6",
      "regionIds": [
        201, 202, 203,   204, 205, 206,   207, 208, 209,
        210, 211, 212,   213, 214, 215,   216, 217, 218,
        219, 220, 221,   222, 223, 224,   225, 226, 227,
        228, 229, 230,   231, 232, 233,   234, 235, 236,
        237, 238, 239,   240, 241, 242
      ]
    }
  ]
}
